4 6
101111
101010
101011
111011
result:
15

4 6
110110
110110
111111
111101
result:
9

2 25
1011101110111011101110111
1110111011101110111011101
result:
38

7 7
1011111
1110001
1000001
1000001
1000001
1000001
1111111
result:
13
